  %%%%%%%%%%%%%%%%%%%%%
%              %      %
% %%%%%%% %%%%%% %  % %
%     %        % %  % %
%                %   %
%%%%%%%%%%%%%%  %%%%%%%
%                     %
%%%%%%%%%%%%%%%%%%%%%